-14
14
-8
9
00000000000000000000000000000
00000000000000000000000011000
01111110000000000000000011110
01000010000000000000000000110
01000010000000000000000000100
01111110000000000000000000100
00010100000000000000000000100
00011100000000000000000000100
00000000000000000000000001100
00010000000000000000000001000
00010000000000000010000001000
00010000000000000010000001000
00010000000000000000000001100
00011111111110111110000000110
00000000000000000000000000000
00000000000000000000000000000
00000000000000000000000000000
00000000000000000000000000000
