-14
14
-8
9
00000000000000000000000000000
00000000000000000000000000000
01111110000000000000000000000
01000010000000000000000000000
01000010000000000000000000000
01111110000000000000000000000
00010100000000000000000000000
00011100000000000000000000000
00000000000000000000000000000
00010000000111111100000000000
00010000000111111110000000000
00010000000111111110000000000
00010000000000000000000000000
00011111110000000000000000000
00000000000000000000000000000
00000000000000000000000000000
00000000000000000000000000000
00000000000000000000000000000
